000010000000000
000010000000000
000010000000000
000000000100000
100000001100000
010000000000000
001000000000000
000100000000000
000000000000000
000000000000000
000000000000000
000000000000000
000000000000000
000000001000000
000000000100000
000000000010000
000000000001000
000000000000100
000000000000000
000000000000000